##########@###
..............
########.####.
########.####$
##############